#MAP
+++++++++++++++++
+---------------+
S>>>>>>>>>>>>>>>G
+---------------+
+---------------+
+---------------+
+---------------+
+---------------+
+---------------+
+---------------+
+---------------+
+---------------+
+---------------+
+++++++++++++++++
+ -> border
- -> ground
S -> path start
G -> path goal
> -> path
make your map inside the border