#MAP
+++++++++++G+++++
+---------->----+
S>>-->>>--->----+
+->-->->--->----+
+->>>>->--->----+
+------>--->----+
+---->>>--->>>>-+
+---->-------->-+
+---->--->>>-->-+
+-->>>--->->>>>-+
+-->----->------+
+-->>>>>>>------+
+---------------+
+++++++++++++++++