#MAP
++++G++++++++++++
+--->>>>>>>>----+
+---------->----+
+---------->----+
+--->>>>--->----+
+--->-->--->----+
+--->-->>>>>----+
+--->-----------+
+--->>>>--------+
+------>--------+
+------>>>>>>>>>S
+---------------+
+---------------+
+++++++++++++++++