#MAP
+++++++++++++++++
+---------------+
S>>>>>>>--------+
+------>--------+
+------>--------+
+------>--------+
+------>--------+
+------>>>>>>>>>G
+---------------+
+---------------+
+---------------+
+---------------+
+---------------+
+++++++++++++++++