#MAP
+++++++++++G+++++
+---------->----+
S>>>>>>>--->----+
+------>--->----+
+------>--->----+
+------>--->----+
+---->>>--->----+
+---->----->----+
+---->----->----+
+---->>>>>>>----+
+---------------+
+---------------+
+---------------+
+++++++++++++++++